%%%%%%%%%%%%%%%%%%%%
%                  %
%..          ... P %
%  ..........      %
%%%%%%%%%%%%%%%%%%%%